f 30 0 0 0 1 1 1 1 1 1 1 1 1 
f 30 1 0 0 0 1 1 1 1 1 1 1 1 
f 30 1 1 0 0 0 1 1 1 1 1 1 1 
f 30 1 1 1 0 0 0 1 1 1 1 1 1 
f 30 1 1 1 1 0 0 0 1 1 1 1 1 
f 30 1 1 1 1 1 0 0 0 1 1 1 1 
f 30 1 1 1 1 1 1 0 0 0 1 1 1 
f 30 1 1 1 1 1 1 1 0 0 0 1 1 
f 30 1 1 1 1 1 1 1 1 0 0 0 1 
f 30 1 1 1 1 1 1 1 1 1 0 0 0 
f 30 0 1 1 1 1 1 1 1 1 1 0 0 
f 30 0 0 1 1 1 1 1 1 1 1 1 0 
f 30 0 0 0 1 1 1 1 1 1 1 1 1 
f 30 1 0 0 0 1 1 1 1 1 1 1 1 
f 30 1 1 0 0 0 1 1 1 1 1 1 1 
f 30 1 1 1 0 0 0 1 1 1 1 1 1 
f 30 1 1 1 1 0 0 0 1 1 1 1 1 
f 30 1 1 1 1 1 0 0 0 1 1 1 1 
f 30 1 1 1 1 1 1 0 0 0 1 1 1 
f 30 1 1 1 1 1 1 1 0 0 0 1 1 
f 30 1 1 1 1 1 1 1 1 0 0 0 1 
f 30 1 1 1 1 1 1 1 1 1 0 0 0 
f 30 0 1 1 1 1 1 1 1 1 1 0 0 
f 30 0 0 1 1 1 1 1 1 1 1 1 0 
f 30 0 0 0 1 1 1 1 1 1 1 1 1 
f 30 1 0 0 0 1 1 1 1 1 1 1 1 
f 30 1 1 0 0 0 1 1 1 1 1 1 1 
f 30 1 1 1 0 0 0 1 1 1 1 1 1 
f 30 1 1 1 1 0 0 0 1 1 1 1 1 
f 30 1 1 1 1 1 0 0 0 1 1 1 1 
